year;month;male;female;number;age mother
1950;january;33504;33511;67015;
1950;february;47177;44298;91475;
1950;march;53604;49499;103103;
1950;april;49606;46030;95636;
1950;may;50932;47046;97978;
1950;june;47795;44566;92361;
1950;july;47377;44324;91701;
1950;august;46297;43163;89460;
1950;september;47342;44363;91705;
1950;october;47370;43885;91255;
1950;november;45319;42065;87384;
1950;december;45867;42940;88807;
1951;january;48747;45169;93916;
1951;february;46034;43054;89088;
1951;march;51546;47987;99533;
1951;april;48568;45721;94289;
1951;may;51257;47832;99089;
1951;june;48082;44531;92613;
1951;july;48104;45423;93527;
1951;august;46619;44191;90810;
1951;september;46892;43785;90677;
1951;october;46144;43279;89423;
1951;november;43521;40671;84192;
1951;december;46185;43038;89223;
1952;january;49430;45802;95232;
1952;february;48218;45256;93474;
1952;march;52374;48948;101322;
1952;april;49339;46092;95431;
1952;may;49970;46624;96594;
1952;june;46570;43251;89821;
1952;july;47445;44735;92180;
1952;august;45717;43107;88824;
1952;september;47560;44540;92100;
1952;october;45077;41963;87040;
1952;november;44318;41497;85815;
1952;december;45134;42117;87251;
1953;january;48762;45878;94640;
1953;february;45993;42934;88927;
1953;march;51863;48831;100694;
1953;april;48983;45909;94892;
1953;may;50261;47167;97428;
1953;june;47266;43922;91188;
1953;july;47554;44688;92242;
1953;august;45574;42981;88555;
1953;september;47423;44422;91845;
1953;october;44129;41869;85998;
1953;november;41667;38722;80389;
1953;december;45454;42777;88231;
1954;january;49374;45922;95296;
1954;february;46442;44240;90682;
1954;march;51116;47245;98361;
1954;april;49118;46291;95409;
1954;may;51948;48596;100544;
1954;june;47975;44911;92886;
1954;july;48350;45317;93667;
1954;august;46817;44027;90844;
1954;september;47434;44213;91647;
1954;october;44235;41978;86213;
1954;november;44121;41345;85466;
1954;december;45629;43099;88728;
1955;january;48920;45879;94799;
1955;february;46908;43699;90607;
1955;march;52337;49558;101895;
1955;april;49525;45827;95352;
1955;may;50317;47388;97705;
1955;june;48065;45074;93139;
1955;july;48073;44571;92644;
1955;august;46829;44107;90936;
1955;september;47581;44341;91922;
1955;october;46060;43208;89268;
1955;november;44361;41474;85835;
1955;december;46103;43203;89306;
1956;january;49009;45921;94930;
1956;february;49507;46494;96001;
1956;march;53872;50950;104822;
1956;april;49671;47230;96901;
1956;may;51840;48505;100345;
1956;june;47419;44123;91542;
1956;july;49070;46252;95322;
1956;august;47689;44789;92478;
1956;september;48296;45516;93812;
1956;october;46313;43722;90035;
1956;november;46094;42977;89071;
1956;december;47347;44563;91910;
1957;january;50451;46879;97330;
1957;february;48828;45789;94617;
1957;march;53725;50749;104474;
1957;april;52096;48769;100865;
1957;may;52779;49268;102047;
1957;june;50134;47296;97430;
1957;july;49613;46569;96182;
1957;august;48667;45332;93999;
1957;september;50597;47261;97858;
1957;october;49181;45938;95119;
1957;november;46610;43629;90239;
1957;december;49360;46035;95395;
1958;january;52132;49176;101308;
1958;february;49458;45897;95355;
1958;march;56123;52955;109078;
1958;april;51114;47717;98831;
1958;may;53326;49590;102916;
1958;june;47464;44251;91715;
1958;july;46900;44122;91022;
1958;august;47978;45335;93313;
1958;september;52771;49462;102233;
1958;october;49695;46680;96375;
1958;november;48541;45480;94021;
1958;december;51593;48110;99703;
1959;january;54487;50764;105251;
1959;february;52466;49275;101741;
1959;march;57974;54838;112812;
1959;april;56064;52468;108532;
1959;may;56215;52969;109184;
1959;june;52798;49779;102577;
1959;july;53562;50444;104006;
1959;august;51909;48658;100567;
1959;september;53143;50343;103486;
1959;october;51763;48133;99896;
1959;november;49188;46316;95504;
1959;december;51808;48558;100366;
1960;january;54289;50853;105142;
1960;february;54491;51615;106106;
1960;march;58142;55292;113434;
1960;april;55235;52112;107347;
1960;may;56559;53486;110045;
1960;june;53514;51243;104757;
1960;july;55055;51966;107021;
1960;august;54661;51213;105874;
1960;september;55039;51791;106830;
1960;october;50500;47831;98331;
1960;november;49407;46301;95708;
1960;december;52036;48983;101019;
1961;january;57282;54337;111619;
1961;february;54611;51605;106216;
1961;march;61385;58262;119647;
1961;april;57799;54585;112384;
1961;may;59034;55442;114476;
1961;june;55192;51662;106854;
1961;july;55718;52364;108082;
1961;august;55341;52477;107818;
1961;september;55993;52443;108436;
1961;october;54632;52169;106801;
1961;november;53178;50374;103552;
1961;december;55252;52368;107620;
1962;january;57507;54258;111765;
1962;february;54228;51409;105637;
1962;march;61044;57246;118290;
1962;april;57159;54587;111746;
1962;may;59400;56020;115420;
1962;june;55868;52584;108452;
1962;july;56392;53156;109548;
1962;august;56563;53155;109718;
1962;september;56523;53207;109730;
1962;october;54500;51619;106119;
1962;november;52876;50160;103036;
1962;december;55223;51850;107073;
1963;january;59825;57038;116863;
1963;february;55824;52369;108193;
1963;march;63946;60682;124628;
1963;april;60164;56953;117117;
1963;may;61515;58635;120150;
1963;june;57072;53410;110482;
1963;july;59068;55814;114882;
1963;august;56941;53624;110565;
1963;september;58532;54842;113374;
1963;october;55583;52838;108421;
1963;november;53425;50482;103907;
1963;december;55091;51922;107013;
1964;january;60261;57323;117584;
1964;february;59063;55646;114709;
1964;march;63123;59815;122938;
1964;april;61452;57715;119167;
1964;may;61107;57138;118245;
1964;june;57453;54641;112094;
1964;july;59240;55589;114829;
1964;august;55726;53147;108873;
1964;september;57926;54740;112666;
1964;october;54266;51488;105754;
1964;november;52192;49301;101493;
1964;december;56237;52715;108952;
1965;january;58109;54666;112775;
1965;february;56247;53481;109728;
1965;march;62501;58880;121381;
1965;april;59027;56113;115140;
1965;may;59906;56439;116345;
1965;june;56585;53165;109750;
1965;july;57310;54158;111468;
1965;august;56368;52949;109317;
1965;september;56812;52996;109808;
1965;october;52678;49679;102357;
1965;november;53217;49893;103110;
1965;december;53440;50767;104207;
1966;january;57833;54979;112812;
1966;february;54757;51537;106294;
1966;march;61847;58855;120702;
1966;april;59040;55492;114532;
1966;may;59914;57165;117079;
1966;june;56831;54197;111028;
1966;july;57308;54085;111393;
1966;august;56192;53045;109237;
1966;september;55401;52823;108224;
1966;october;53428;50834;104262;
1966;november;51877;48623;100500;
1966;december;52625;49615;102240;
1967;january;55945;52668;108613;
1967;february;54409;51214;105623;
1967;march;59393;56453;115846;
1967;april;56508;53310;109818;
1967;may;58481;55214;113695;
1967;june;54465;51564;106029;
1967;july;54834;52140;106974;
1967;august;53510;50509;104019;
1967;september;53679;50698;104377;
1967;october;51989;49460;101449;
1967;november;49281;47139;96420;
1967;december;51155;48258;99413;
1968;january;55605;52947;108552;
1968;february;52939;50347;103286;
1968;march;57358;54163;111521;
1968;april;54526;51532;106058;
1968;may;55418;52335;107753;
1968;june;51951;48804;100755;
1968;july;51798;49462;101260;
1968;august;51503;48488;99991;
1968;september;50574;48122;98696;
1968;october;47302;44526;91828;
1968;november;46159;43732;89891;
1968;december;49240;46137;95377;
1969;january;52989;50351;103340;
1969;february;49130;45495;94625;
1969;march;55019;51845;106864;
1969;april;51422;48599;100021;
1969;may;52103;49028;101131;
1969;june;48146;45673;93819;
1969;july;50273;47935;98208;
1969;august;47492;44254;91746;
1969;september;48165;45420;93585;
1969;october;45407;43193;88600;
1969;november;42868;40971;83839;
1969;december;44429;42159;86588;
1970;january;46129;43527;89656;
1970;february;43563;41506;85069;
1970;march;49334;46466;95800;
1970;april;46787;44462;91249;
1970;may;47123;44633;91756;
1970;june;45829;43229;89058;
1970;july;46282;44141;90423;
1970;august;43555;41540;85095;
1970;september;42161;39898;82059;
1970;october;40898;38562;79460;
1970;november;41394;38889;80283;
1970;december;44867;42962;87829;
1971;january;45369;43160;88529;
1971;february;42462;40565;83027;
1971;march;48058;45252;93310;
1971;april;45463;42441;87904;
1971;may;46004;43160;89164;
1971;june;43373;41014;84387;
1971;july;44381;41816;86197;
1971;august;42007;39898;81905;
1971;september;43021;40379;83400;
1971;october;40968;38658;79626;
1971;november;40128;37685;77813;
1971;december;40127;38007;78134;
1972;january;42287;40091;82378;
1972;february;40865;38281;79146;
1972;march;43491;41124;84615;
1972;april;40724;38830;79554;
1972;may;42112;39987;82099;
1972;june;40674;38227;78901;
1972;july;40168;37759;77927;
1972;august;36897;34603;71500;
1972;september;35228;33579;68807;
1972;october;34205;32449;66654;
1972;november;33144;31366;64510;
1972;december;33677;31889;65566;
1973;january;37084;35428;72512;
1973;february;33694;32084;65778;
1973;march;38035;35761;73796;
1973;april;35461;33830;69291;
1973;may;36693;34477;71170;
1973;june;35722;33535;69257;
1973;july;36745;34521;71266;
1973;august;35035;33136;68171;
1973;september;33977;32179;66156;
1973;october;32855;31558;64413;
1973;november;31768;29877;61645;
1973;december;31830;30684;62514;
1974;january;36052;34199;70251;
1974;february;32431;30268;62699;
1974;march;36896;35514;72410;
1974;april;35149;33155;68304;
1974;may;37396;35086;72482;
1974;june;34171;32430;66601;
1974;july;36066;34356;70422;
1974;august;35213;33421;68634;
1974;september;35087;33261;68348;
1974;october;33021;31255;64276;
1974;november;30857;29496;60353;
1974;december;31171;29549;60720;
1975;january;35419;33057;68476;
1975;february;32215;30301;62516;
1975;march;35292;33924;69216;
1975;april;34706;32768;67474;
1975;may;35199;33457;68656;
1975;june;33599;31534;65133;
1975;july;35285;33290;68575;
1975;august;33734;31702;65436;
1975;september;33366;31584;64950;
1975;october;31496;29621;61117;
1975;november;30366;28175;58541;
1975;december;32113;30107;62220;
1976;january;35468;33398;68866;
1976;february;33013;31198;64211;
1976;march;36268;34773;71041;
1976;april;33975;31937;65912;
1976;may;35261;33529;68790;
1976;june;34362;32511;66873;
1976;july;35360;33786;69146;
1976;august;34870;32988;67858;
1976;september;35449;33461;68910;
1976;october;32666;31047;63713;
1976;november;31065;30146;61211;
1976;december;31992;29811;61803;
1977;january;33862;31876;65738;
1977;february;31856;30026;61882;
1977;march;37077;34554;71631;
1977;april;34613;32562;67175;
1977;may;37351;34900;72251;
1977;june;35518;33854;69372;
1977;july;35481;33542;69023;
1977;august;35019;33061;68080;
1977;september;35409;33358;68767;
1977;october;33717;31847;65564;
1977;november;31998;30588;62586;
1977;december;32748;30679;63427;
1978;january;34632;32906;67538;
1978;february;32778;31052;63830;
1978;march;37219;34899;72118;
1978;april;35575;33525;69100;
1978;may;37335;35190;72525;
1978;june;35164;33321;68485;
1978;july;36345;33927;70272;
1978;august;34425;32872;67297;
1978;september;34865;32857;67722;
1978;october;33345;31526;64871;
1978;november;31238;29790;61028;
1978;december;32945;30888;63833;
1979;january;35051;33088;68139;
1979;february;31833;30508;62341;
1979;march;36080;34495;70575;
1979;april;35196;33194;68390;
1979;may;36700;34790;71490;
1979;june;34261;32651;66912;
1979;july;36684;34569;71253;
1979;august;36282;33972;70254;
1979;september;35982;34042;70024;
1979;october;34615;33476;68091;
1979;november;33211;31227;64438;
1979;december;33695;31615;65310;
1980;january;36705;35474;72179;
1980;february;35035;32838;67873;
1980;march;37532;35774;73306;
1980;april;36925;34878;71803;
1980;may;38406;36674;75080;
1980;june;37108;35116;72224;
1980;july;39615;37665;77280;
1980;august;37650;35497;73147;
1980;september;37493;35946;73439;
1980;october;36751;34811;71562;
1980;november;34581;32603;67184;
1980;december;36347;34365;70712;
1981;january;36999;34625;71624;
1981;february;35324;33387;68711;
1981;march;37744;36525;74269;
1981;april;37108;34694;71802;
1981;may;37023;35316;72339;
1981;june;36807;35107;71914;
1981;july;39386;37082;76468;
1981;august;38447;36310;74757;
1981;september;38641;36353;74994;
1981;october;35556;34215;69771;
1981;november;34030;32361;66391;
1981;december;35475;33585;69060;
1982;january;36996;35017;72013;
1982;february;34498;32682;67180;
1982;march;38619;36486;75105;
1982;april;36338;34198;70536;
1982;may;36708;34472;71180;
1982;june;37219;34971;72190;
1982;july;39211;36843;76054;
1982;august;38428;35879;74307;
1982;september;38425;36552;74977;
1982;october;36466;34919;71385;
1982;november;34186;33057;67243;
1982;december;35665;33440;69105;
1983;january;35742;33820;69562;
1983;february;33739;32238;65977;
1983;march;37050;35237;72287;
1983;april;34954;32769;67723;
1983;may;36971;34876;71847;
1983;june;35917;33971;69888;
1983;july;36966;34899;71865;
1983;august;37097;35192;72289;
1983;september;36330;34574;70904;
1983;october;34336;32529;66865;
1983;november;33009;30721;63730;
1983;december;33328;31668;64996;
1984;january;33903;32113;66016;
1984;february;33697;31993;65690;
1984;march;36079;34306;70385;
1984;april;33779;31884;65663;
1984;may;35880;33576;69456;
1984;june;34591;32810;67401;
1984;july;36793;34858;71651;
1984;august;36392;34426;70818;
1984;september;35241;33885;69126;
1984;october;34754;33029;67783;
1984;november;33093;31093;64186;
1984;december;33045;31072;64117;
1985;january;35238;33494;68732;
1985;february;32443;30675;63118;
1985;march;36463;34468;70931;
1985;april;34842;33341;68183;
1985;may;36220;33914;70134;
1985;june;33609;31914;65523;
1985;july;37041;35300;72341;
1985;august;35886;33742;69628;
1985;september;35985;34849;70834;
1985;october;35038;33308;68346;
1985;november;32239;30806;63045;
1985;december;32244;30744;62988;
1986;january;36092;34194;70286;
1986;february;32929;31929;64858;
1986;march;36056;34351;70407;
1986;april;36747;34675;71422;
1986;may;36820;34887;71707;
1986;june;36301;33962;70263;
1986;july;37850;36061;73911;
1986;august;37441;35691;73132;
1986;september;38737;36551;75288;
1986;october;36449;35010;71459;
1986;november;33570;31833;65403;
1986;december;35909;34187;70096;
1987;january;36824;34860;71684;
1987;february;33835;32105;65940;
1987;march;37506;35748;73254;
1987;april;36371;34183;70554;
1987;may;38401;35952;74353;
1987;june;38873;36271;75144;
1987;july;40467;37787;78254;
1987;august;38884;36868;75752;
1987;september;39145;36688;75833;
1987;october;36381;34543;70924;
1987;november;34428;32579;67007;
1987;december;35556;33714;69270;
1988;january;38597;36517;75114;
1988;february;36463;34886;71349;
1988;march;40007;38053;78060;
1988;april;36287;34287;70574;
1988;may;39308;37366;76674;
1988;june;37574;35266;72840;
1988;july;39883;37445;77328;
1988;august;40345;38107;78452;
1988;september;40338;38318;78656;
1988;october;37395;35256;72651;
1988;november;35810;33933;69743;
1988;december;37044;34508;71552;
1989;january;37352;35482;72834;
1989;february;35654;33591;69245;
1989;march;38413;36730;75143;
1989;april;36557;34755;71312;
1989;may;38645;36045;74690;
1989;june;37356;35351;72707;
1989;july;40219;38566;78785;
1989;august;39951;37970;77921;
1989;september;38310;36493;74803;
1989;october;36860;35009;71869;
1989;november;35409;33604;69013;
1989;december;36860;35277;72137;
1990;january;39234;36566;75800;
1990;february;36029;34462;70491;
1990;march;39674;36956;76630;
1990;april;37435;35179;72614;
1990;may;39290;37276;76566;
1990;june;37519;35553;73072;
1990;july;41660;39438;81098;
1990;august;41787;39776;81563;
1990;september;41315;39034;80349;
1990;october;39337;37419;76756;
1990;november;36269;34214;70483;
1990;december;35830;34423;70253;
1991;january;38031;35973;74004;
1991;february;34060;32266;66326;
1991;march;36410;34810;71220;
1991;april;35147;33131;68278;
1991;may;36050;34394;70444;
1991;june;35707;33057;68764;
1991;july;37951;36068;74019;
1991;august;37087;35008;72095;
1991;september;36931;35099;72030;
1991;october;33731;32175;65906;
1991;november;32314;30666;62980;
1991;december;32679;31274;63953;
1992;january;35636;33812;69448;
1992;february;33973;32356;66329;
1992;march;35256;33798;69054;
1992;april;33213;31925;65138;
1992;may;34485;33158;67643;
1992;june;34577;32841;67418;
1992;july;37326;35208;72534;
1992;august;36600;34524;71124;
1992;september;36228;34595;70823;
1992;october;33091;31539;64630;
1992;november;31490;29896;61386;
1992;december;32932;30655;63587;
1993;january;35537;34073;69610;
1993;february;32408;30826;63234;
1993;march;35206;33576;68782;
1993;april;33527;31420;64947;
1993;may;33721;31821;65542;
1993;june;34543;32674;67217;
1993;july;37064;34919;71983;
1993;august;36284;34266;70550;
1993;september;35860;34055;69915;
1993;october;33279;31563;64842;
1993;november;30972;29201;60173;
1993;december;31670;29982;61652;
1994;january;33328;31230;64558;
1994;february;30938;28964;59902;
1994;march;33835;31737;65572;
1994;april;32863;31004;63867;
1994;may;33736;31977;65713;
1994;june;33661;31660;65321;
1994;july;35173;32671;67844;
1994;august;34318;32653;66971;
1994;september;33514;32208;65722;
1994;october;31945;30158;62103;
1994;november;30659;29053;59712;
1994;december;31899;30419;62318;
1995;january;32995;30797;63792;
1995;february;29935;29143;59078;
1995;march;32931;31334;64265;
1995;april;29693;28477;58170;
1995;may;32011;29686;61697;
1995;june;33492;31573;65065;
1995;july;35583;33840;69423;
1995;august;35244;33385;68629;
1995;september;34431;32914;67345;
1995;october;33708;32058;65766;
1995;november;31332;29668;61000;
1995;december;31374;29617;60991;
1996;january;32691;31208;63899;
1996;february;31892;30082;61974;
1996;march;33349;31813;65162;
1996;april;31623;30005;61628;
1996;may;33092;31000;64092;
1996;june;33889;31896;65785;
1996;july;36898;34880;71778;
1996;august;36667;34603;71270;
1996;september;36565;34603;71168;
1996;october;34821;33048;67869;
1996;november;33175;31298;64473;
1996;december;34551;32364;66915;
1997;january;36208;34138;70346;
1997;february;33225;31458;64683;
1997;march;33768;32161;65929;
1997;april;34525;32883;67408;
1997;may;35634;33389;69023;
1997;june;35704;33827;69531;
1997;july;37883;35741;73624;
1997;august;36393;34469;70862;
1997;september;36147;34308;70455;
1997;october;33966;32260;66226;
1997;november;30755;29434;60189;
1997;december;32798;31099;63897;
1998;january;34276;32612;66888;
1998;february;31550;29725;61275;
1998;march;33666;31723;65389;
1998;april;32997;31323;64320;
1998;may;33116;31574;64690;
1998;june;32804;30649;63453;
1998;july;36978;34765;71743;
1998;august;35592;34050;69642;
1998;september;36009;34413;70422;
1998;october;33067;31532;64599;
1998;november;31155;29587;60742;
1998;december;31655;30216;61871;
1999;january;33757;31981;65738;
1999;february;30745;29323;60068;
1999;march;32707;31245;63952;
1999;april;31843;29929;61772;
1999;may;33898;31369;65267;
1999;june;33633;31629;65262;
1999;july;36073;34329;70402;
1999;august;35307;33193;68500;
1999;september;35111;33384;68495;
1999;october;31861;30180;62041;
1999;november;29756;28015;57771;
1999;december;31605;29871;61476;
2000;january;33931;31784;65715;
2000;february;32025;30484;62509;
2000;march;33116;31349;64465;
2000;april;31467;29748;61215;
2000;may;33270;31734;65004;
2000;june;32533;30934;63467;
2000;july;34741;32823;67564;
2000;august;34921;33335;68256;
2000;september;34034;32431;66465;
2000;october;32410;30568;62978;
2000;november;29919;28757;58676;
2000;december;30956;29729;60685;
2001;january;33013;30893;63906;
2001;february;28724;26794;55518;
2001;march;31258;29634;60892;
2001;april;30418;28404;58822;
2001;may;32474;30760;63234;
2001;june;31489;29876;61365;
2001;july;34248;32125;66373;
2001;august;33576;32001;65577;
2001;september;32164;30992;63156;
2001;october;31341;29817;61158;
2001;november;29441;27733;57174;
2001;december;29440;27860;57300;
2002;january;31362;29441;60803;
2002;february;28460;27282;55742;
2002;march;31052;29825;60877;
2002;april;29601;28305;57906;
2002;may;30297;28589;58886;
2002;june;30421;28614;59035;
2002;july;33536;31551;65087;
2002;august;32759;30838;63597;
2002;september;32597;30858;63455;
2002;october;31439;29784;61223;
2002;november;28451;26889;55340;
2002;december;29302;27997;57299;
2003;january;30177;28902;59079;
2003;february;27431;26088;53519;
2003;march;29550;27823;57373;
2003;april;29053;27923;56976;
2003;may;30361;28895;59256;
2003;june;30499;28664;59163;
2003;july;34048;31918;65966;
2003;august;32153;30710;62863;
2003;september;32594;31060;63654;
2003;october;30337;28738;59075;
2003;november;27646;26224;53870;
2003;december;28860;27067;55927;
2004;january;30669;28964;59633;
2004;february;27981;26937;54918;
2004;march;29070;27647;56717;
2004;april;28786;26885;55671;
2004;may;29118;27463;56581;
2004;june;31068;29061;60129;
2004;july;33680;31505;65185;
2004;august;32876;31265;64141;
2004;september;31980;30727;62707;
2004;october;29875;28499;58374;
2004;november;27964;26605;54569;
2004;december;28950;28047;56997;
2005;january;29464;27874;57338;
2005;february;27285;25880;53165;
2005;march;29106;27965;57071;
2005;april;28614;27070;55684;
2005;may;29093;27773;56866;
2005;june;29869;28277;58146;
2005;july;31768;29703;61471;
2005;august;31520;29956;61476;
2005;september;31052;29618;60670;
2005;october;28911;27508;56419;
2005;november;26933;25832;52765;
2005;december;28142;26582;54724;
2006;january;28560;26739;55299;
2006;february;26275;25065;51340;
2006;march;28375;27272;55647;
2006;april;27031;25119;52150;
2006;may;30005;28238;58243;
2006;june;29077;27404;56481;
2006;july;31221;29791;61012;
2006;august;31093;29433;60526;
2006;september;30966;29184;60150;
2006;october;29392;28125;57517;
2006;november;27036;25468;52504;
2006;december;26785;25070;51855;
2007;january;29346;27932;57278;
2007;february;26262;24878;51140;
2007;march;29045;27220;56265;
2007;april;26342;24853;51195;
2007;may;29195;27147;56342;
2007;june;29527;27971;57498;
2007;july;31628;30143;61771;
2007;august;32313;30252;62565;
2007;september;31635;30253;61888;
2007;october;30441;29039;59480;
2007;november;27839;26538;54377;
2007;december;28266;26797;55063;
2008;january;30041;28478;58519;
2008;february;27211;26159;53370;
2008;march;27302;25550;52852;
2008;april;28123;26925;55048;
2008;may;29504;27894;57398;
2008;june;29916;28397;58313;
2008;july;32360;30955;63315;
2008;august;31235;29689;60924;
2008;september;31541;29722;61263;
2008;october;29186;27671;56857;
2008;november;26345;25358;51703;
2008;december;27098;25854;52952;
2009;january;28275;26880;55155;
2009;february;25607;24480;50087;
2009;march;27284;26408;53692;
2009;april;27422;25755;53177;
2009;may;28059;26476;54535;
2009;june;29152;27604;56756;
2009;july;31964;30328;62292;
2009;august;30812;29060;59872;
2009;september;30618;28994;59612;
2009;october;28134;26626;54760;
2009;november;26427;24892;51319;
2009;december;27495;26374;53869;
2010;january;28302;26971;55273;
2010;february;25632;24682;50314;
2010;march;28310;27176;55486;
2010;april;26832;25188;52020;
2010;may;28682;27372;56054;
2010;june;29604;27927;57531;
2010;july;31706;30212;61918;
2010;august;30600;29245;59845;
2010;september;31297;29828;61125;
2010;october;30339;28477;58816;
2010;november;27852;26724;54576;
2010;december;28081;26908;54989;
2011;january;27983;26819;54802;
2011;february;25915;24605;50520;
2011;march;27579;25854;53433;
2011;april;25449;24342;49791;
2011;may;28403;26656;55059;
2011;june;29298;27649;56947;
2011;july;31365;29804;61169;
2011;august;31324;29482;60806;
2011;september;30648;29660;60308;
2011;october;28613;27324;55937;
2011;november;26389;25302;51691;
2011;december;26933;25289;52222;
2012;january;28042;26486;54528;
2012;february;26302;24978;51280;
2012;march;28042;26984;55026;
2012;april;27494;25665;53159;
2012;may;29222;27461;56683;
2012;june;28662;26863;55525;
2012;july;31343;30003;61346;
2012;august;31482;30192;61674;
2012;september;30441;29174;59615;
2012;october;29609;28247;57856;
2012;november;27630;25960;53590;
2012;december;27360;25902;53262;
2013;january;28739;27180;55919;
2013;february;25655;24131;49786;
2013;march;27664;26558;54222;
2013;april;27648;25989;53637;
2013;may;29358;27410;56768;
2013;june;29315;27754;57069;
2013;july;33045;31163;64208;
2013;august;31768;30672;62440;
2013;september;32007;30718;62725;
2013;october;29646;28479;58125;
2013;november;27342;25643;52985;
2013;december;27633;26552;54185;
2014;january;29448;28069;57517;
2014;february;27289;26055;53344;
2014;march;28839;27481;56320;
2014;april;28731;27328;56059;
2014;may;30744;28459;59203;
2014;june;31224;29322;60546;
2014;july;34231;32729;66960;
2014;august;33112;31346;64458;
2014;september;33225;31766;64991;
2014;october;31499;30097;61596;
2014;november;28787;27349;56136;
2014;december;29706;28091;57797;
2015;january;21134;20353;41487;
2015;february;25944;24686;50630;
2015;march;30453;29020;59473;
2015;april;29163;27980;57143;
2015;may;28002;26720;54722;
2015;june;33603;31830;65433;
2015;july;35972;33830;69802;
2015;august;33144;31001;64145;
2015;september;34990;32812;67802;
2015;october;33813;32370;66183;
2015;november;29925;28680;58605;
2015;december;42360;39845;82205;
